30 30

0  0  0  0  0  0  0  0  0  0  0  0  0  0  0  0  0  0  0  0  0  0  0  0  0  0  0  0  0  0 
0 27 0 0 0 0 0 0 0 0 0 0 0 0 0 0 0 0 0 0 0 0 0 0 0 0 0 0 0 0
0 0 27 0 0 0 0 0 0 0 0 0 0 0 0 0 0 0 0 0 0 0 0 0 0 0 0 0 0 0
0 0 0 0 7 4 4 4 4 4 4 4 4 4 4 4 4 4 4 4 4 4 4 4 4 4 8 0 0 0 
0 0 0 7 21 1 1 1 1 1 1 1 1 1 1 1 1 1 1 1 1 1 1 1 1 1 22 8 0 0
0 0 0 3 1 1 1 1 1 1 1 1 1 1 1 1 1 1 1 1 1 1 1 1 1 1 1 5 0 0 
0 0 0 3 1 1 1 1 1 1 1 1 1 1 1 1 1 1 1 1 1 1 1 1 1 1 1 5 0 0 
0 0 0 3 1 1 1 1 1 1 1 1 1 1 1 1 1 1 1 1 1 1 1 1 1 1 1 5 0 0
0 0 0 3 1 1 1  15 12 12 12 12 12 12 12 12 12 12 12 12 12 12 12 16 1 1 1 5 0 0 
0 0 0 3 1 1 15  25  2  2  2  2  2  2  2  2  2  2  2  2  2  2  2  26  16 1 1 5 0 0 
0 0 0 3 1 1 11  2  2  2  2  2  2  2  2  2  2  2 2 2 2 2 2 2 13 1 1 5 0 0 
0 0 0 3 1 1 11  2  2  2  2  2  2  2  2  2 2 2 2 2 2 2 2 2 13 1 1 5 0 0 
0 0 0 3 1 1 11  2  2  2  2 2 2 2 2 2 2 2 2 2 2 2 2 2 13 1 1 5 0 0 
0 0 0 3 1 1 11  2  2  2  2 2 2 2 2 2 2 2 2 2 2 2 2 2 13 1 1 5 0 0 
0 0 0 3 1 1 11  2  2  2  2 2 2 2 2 2 2 2 2 2 2 2 2 2 13 1 1 5 0 0
0 0 0 3 1 1 11  2  2  2  2 2 2 2 2 2 2 2 2 2 2 2 2 2 13 1 1 5 0 0 
0 0 0 3 1 1 11  2  2  2  2 2 2 2 2 2 2 2 2 2 2 2 2 2 13 1 1 5 0 0
0 0 0 3 1 1 11  2  2  2  2 2 2 2 2 2 2 2 2 2 2 2 2 2 13 1 1 5 0 0 
0 0 0 3 1 1 11  2  2  2  2 2 2 2 2 2 2 2 2 2 2 2 2 2 13 1 1 5 0 0
0 0 0 3 1 1 11  2  2  2  2  2  2  2 2 2 2 2 2 2 2 2 2 2 13 1 1 5 0 0
0 0 0 3 1 1 11  2  2  2  2  2  2  2 2 2 2 2 2 2 2 2 2 2 13 1 1 5 0 0 
0 0 0 3 1 1 18  24  2  2  2  2  2  2 2 2 2 2 2 2 2 2 2 23 17 1 1 5 0 0 
0 0 0 3 1 1 1   18 14 14 14 14 14 14 14 14 14 14 14 14 14 14 14 17 1 1 1 5 0 0 
0 0 0 3 1 1 1 1 1 1 1 1 1 1 1 1 1 1 1 1 1 1 1 1 1 1 1 5 0 0
0 0 0 3 1 1 1 1 1 1 1 1 1 1 1 1 1 1 1 1 1 1 1 1 1 1 1 5 0 0 
0 0 0 10 20 1 1 1 1 1 1 1 1 1 1 1 1 1 1 1 1 1 1 1 1 1 19 9 0 0
0 0 0 0  10 6 6 6 6 6 6 6 6 6 6 6 6 6 6 6 6 6 6 6 6 6 9 0 0 0 
0 27 0 0 0 0 0 0 0 0 0 0 0 0 0 0 0 0 0 0 0 0 0 0 0 0 0 0 0 0
0 0 0 0 0 0 0 0 0 0 0 0 0 0 0 0 0 0 0 0 0 0 0 0 0 0 0 0 0 0 
0 0 0 0 0 0 0 0 0 0 0 0 0 0 0 0 0 0 0 0 0 0 0 0 0 0 0 0 0 0
